NO ./gfx/nwall.xpm
SO ./gfx/swall.xpm
EA ./gfx/ewall.xpm
WE ./gfx/wwall.xpm
FT ./gfx/floor.xpm
CT ./gfx/sky.xpm
F 255,248,220
C 135,206,250



 1111    1111     1111    1111
1000W1  100001   100001  100001
1011111111011111111101111111101
10000000000000000000000000000001
 1101111111110111111111011111101
100001110000000000001 100001 101111111111   11
10000001100000111001   1111  1000000000001 1001
 111011  11111   10011100001  11101111101  1001
  110111  10001 101010010001    101   101  1001
 1000001  101011100000000001    101   101  1001
10000000110000000000000010001  10001 10001100001
1000000000000001101000010001   10001 10001100001
 100000111000001 111010110001   101   101  1001
  11011   10101    111010001    101   101  1001
    1      1 1        1 111     101  10001100001
11111111111111111111111111111111101  10001100001
10000000010000000000100000010000001  10001100001
11111111010111111110101111010111101  1101  11101
       10001      10001  1000100001  1001  10001
       1011       1011   111000111   101   1011
       1001       1001      111      101   101
       101        1101               101   101
       1001       1001              1001  1001
        101       101              1001  1001
        101       101             1001  1001
        1001     10001           1001  1001
         101    10011           1001  1001
         101    101             101    101
         101    101             101    1001
         101    101             101     101
         101    101             101     101
         1011111101111111111111110111111101
         1000010100000000010000010000010001
         1111110101111111010111010111011101
         1000000000000000000000000000000001
          11111111111111111111111111111111