NO ./gfx/nwall.xpm
SO ./gfx/swall.xpm
WE ./gfx/wwall.xpm
EA ./gfx/ewall.xpm

FT ./gfx/floor.xpm
CT ./gfx/sky.xpm

F 255,248,220
C 135,206,250

MAP
1111111111111111111111111
1000000000110000000000001
1011000001110000000000001
1001000000000000000000001
1011000001110000000000001
10000000001100000111011111111
11110111111111011100000000001
11110111  100011101010010001
11000001  10101110000000000
10000000110000001100000010001
100000S0000000001101010010001
 100000111010101111101111000111
  1101111110101  101111010001
   111111111111  111111111111