  NO ./gfx/colorstone.xpm

     SO ./gfx/bluestone.xpm

  WE ./gfx/greystone.xpm

EA ./gfx/wood.xpm

FT ./gfx/floor.xpm
CT ./gfx/sky.xpm

F 255,248,220
C 135,206,250

MAP
1111111111111111111111111
1000000000110000000000001
101100000111000000S000001
1001000000000000000000001
1111111110110000011100001
1000000000110000011101111
1111011111111101110000001
1111011111111101110101001
1100000011010101110000001
1000000000000000110000001
1000000000000000110101001
1100000111010101111101101
1111011111110101110111101
1111111111111111111111111
