NO ./gfx/colorstone.xpm
SO ./gfx/bluestone.xpm
WE ./gfx/greystone.xpm
EA ./gfx/wood.xpm

FT ./gfx/floor.xpm
CT ./gfx/sky.xpm

F 255,248,220
C 135,206,250

MAP
111111
100101
101001
1100N1
111111