NO ./gfx/colorstone.xpm
SO ./gfx/bluestone.xpm
WE ./gfx/greystone.xpm
EA ./gfx/wood.xpm

FT ./gfx/floor.xpm
CT ./gfx/sky.xpm

F 255,248,220
C 135,206,250

MAP
111111
1001001
1011001
110N111
111111