NO ./gfx/nwall.xpm
SO ./gfx/swall.xpm
WE ./gfx/wwall.xpm
EA ./gfx/ewall.xpm

FT ./gfx/floor.xpm
CT ./gfx/sky.xpm

F 12,255,248,220
C 50,135,206,250

P ./gfx/player.xpm
D ./gfx/door.xpm


111111  111111   111111  111111
1I00W1  1000I1   1I0001  1I0001
1D11111111D111111111D11111111D1
1000I000000000I00000000000I00001
 11D111111111D111111111D11111101
1000011100000000I0001 100001 1D11111111111 1111
1000I00110I000111I11   1111  1000000000001 1001
1111D11  11111   11I1110I001 1111D11111D11 1001
  11D111  10001 101D10010001    101   101  1001
11000001  101011100000000001    101   101  1001
1000000011000000D00I000010001  10001 10001100001
1000I000D000I001101000010001   10001 10001100001
 100000111000001 111010110001   101   1D1  1001
  11I11   1I1I1    111I10001    1D1   101  1001
    1      1 1        1 111     101  10001100001
11111111111111111111111111111111101  10001100001
1I0D0000010000D00I00100D000100D0001  10001100001
11111111D1D11111111D1D1111D1D1111D1  11D1  111D1
       10001      10001  1000100001  1001  10001
       1011       1011   111000111   101   1011
       10I1       10I1      111      101   101
       101        1101               101   101
       1001       1001              1001  1001
        101       101              1001  1001
        101       101             1001  1001
        1001     10001           1001  1001
         101    10011           1001  1001
         101    101             1D1    1D1
         1I1    1I1             101    1001
         101    101             101     101
         101    101             1D1     1D1
         1D111111D11111111111111101111111I1
         100I010100I00D0I0100I00100I0010001
         111111D1D11111110101110101110111D1
         1I000D00I00D000I00000I000D0000D0I1
          11111111111111111111111111111111